{
  "a": "p",
  "b": "n",
  "c": "e",
  "d": "u",
  "e": "m",
  "f": "o",
  "g": "n",
  "h": "u",
  "i": "l",
  "j": "t",
  "k": "r",
  "l": "a",
  "m": "i",
  "n": "c",
  "o": "r",
  "p": "s",
  "q": "p",
  "r": "n",
  "s": "a"
}
